{
    "key":  "GEN-01",
    "title":  "발전기 가동",
    "description":  "발전기를 단계별로 가동하고 방어 라인을 유지해야 한다.",
    "tileSize":  80,
    "events":  [
                   {
                       "id":  "A0-GEN",
                       "type":  "generator",
                       "title":  "발전기 가동",
                       "tileX":  14,
                       "tileY":  9,
                       "radius":  140
                   },
                   {
                       "id":  "A0-KEY",
                       "type":  "key",
                       "title":  "보안키 획득",
                       "tileX":  18,
                       "tileY":  19,
                       "radius":  140
                   },
                   {
                       "id":  "A0-GATE",
                       "type":  "gate",
                       "title":  "웨이브 보안문",
                       "tileX":  57,
                       "tileY":  10,
                       "radius":  120
                   },
                   {
                       "id":  "A0-EXIT",
                       "type":  "exit",
                       "title":  "탈출 통로",
                       "tileX":  76,
                       "tileY":  10,
                       "radius":  140
                   }
               ],
    "tiles":  [
                  "~~~~~~~~~~~~~~~~~~~~~~~~~~~~~~~~~~~~~~~~~~~~~~~~~~~~~~~~~~~~~~~~~~~~~~~~~~~~~~~~",
                  "~~~~~~~~~~~~~~~~~~~~~~~~~~~~~~~~~~~~~~~~~~~~~~~~~~~~~~~~~~~~~~~~~~~~~~~~~~~~~~~~",
                  "~~~~~~~~~~~~~~~~~~~~~~~~~~~~~~~~~~~~~~~~~~~~~~~~~~~~~~~~~~~~~~~~~~~~~~~~~~~~~~~~",
                  "~~~~~~~~~~~~~~~~~~~~~~~~~~~~~~~~~~~~~~~~~~~~~~~~~~~~~~~~~~~~~~~~~~~~~~~~~~~~~~~~",
                  "~~~~~~~~~~~~~~~~~~~~~~~~~~~~~~~~~~~~~~~~~~~~~~~~~~~~~~~~~~~~~~~~~~~~~~~~~~~~~~~~",
                  "~~~~~~~~################################################~~~~~~~~~~~~~~~~~~~~~~~~",
                  "~~~~~~~~#..............................................#~~~~~~~~~~~~~~~~~~~~~~~~",
                  "~~~~~~~~#..............................................#~~~~~~~~~~~~~~~~~~~~~~~~",
                  "~~~~~~~~#..............................................#~~~~~~~~~~~~~~~~~~~~~~~~",
                  "~~~~~~~~#..............................................#~~~~~~~~~~~~~~~~~~~~~~~~",
                  "~~~~~~~~#...................................................................E.~~",
                  "~~~~~~~~#.....................................................................~~",
                  "~~~~~~~~#..............................................#~~~~~~~~~~~~~~~~~~~~~~~~",
                  "~~~~~~~~#.........############.###############.........#~~~~~~~~~~~~~~~~~~~~~~~~",
                  "~~~~~~~~#...................#..........................#~~~~~~~~~~~~~~~~~~~~~~~~",
                  "~~~~~~~~#...................#..........................#~~~~~~~~~~~~~~~~~~~~~~~~",
                  "~~~~~~~~#...................#..........................#~~~~~~~~~~~~~~~~~~~~~~~~",
                  "~~~~~~~~#..............................................#~~~~~~~~~~~~~~~~~~~~~~~~",
                  "~~~~~~~~#...................#..........................#~~~~~~~~~~~~~~~~~~~~~~~~",
                  "~~~~~~~~#...................#..........................#~~~~~~~~~~~~~~~~~~~~~~~~",
                  "~~~~~~~~#...................#..........................#~~~~~~~~~~~~~~~~~~~~~~~~",
                  "~~~~~~~~#..............................................#~~~~~~~~~~~~~~~~~~~~~~~~",
                  "~~~~~~~~#..............................................#~~~~~~~~~~~~~~~~~~~~~~~~",
                  "~~~~~~~~#..............................................#~~~~~~~~~~~~~~~~~~~~~~~~",
                  "~~~~~~~~#..............................................#~~~~~~~~~~~~~~~~~~~~~~~~",
                  "~~~~~~~~#..............................................#~~~~~~~~~~~~~~~~~~~~~~~~",
                  "~~~~~~~~#...############################################~~~~~~~~~~~~~~~~~~~~~~~~",
                  "~~~~~~~~~~S~~~~~~~~~~~~~~~~~~~~~~~~~~~~~~~~~~~~~~~~~~~~~~~~~~~~~~~~~~~~~~~~~~~~~",
                  "~~~~~~~~~~~~~~~~~~~~~~~~~~~~~~~~~~~~~~~~~~~~~~~~~~~~~~~~~~~~~~~~~~~~~~~~~~~~~~~~",
                  "~~~~~~~~~~~~~~~~~~~~~~~~~~~~~~~~~~~~~~~~~~~~~~~~~~~~~~~~~~~~~~~~~~~~~~~~~~~~~~~~"
              ],
    "objectives":  [
                       "발전기 A 구동",
                       "발전기 B 구동",
                       "발전기 과부하 방지",
                       "탈출 지점 확보"
                   ]
}
